Locus Name	Forward Primer	Reverse Primer	Motif
TG_MS1	TGCACCCGTGTTCAATTTC	CACGGTGTCCAGAAATGCC	AT
TG_MS3	GGCTATTGACGTTGTAGGCG	TGACGTAACTGAGGCACCC	AT
TG_MS4	TGAAATGATGAGCTTCTTGGGC	AGTCGAGTACAGGGTGTTAAATTATG	AT
TG_MS8	GAGCCTGCTGCAACTTTCG	GGGTCAATTCTTCAGTGATGGC	AT
TG_MS11	CCTCGAACTTATACTGATTTCTCAAG	GCTGTAAAGCTGAGGACTAAC	AT
TG_MS12	CTTCGCTCCCTCAAATGGTC	GCGAAAGGCTAGATGGACG	ATT
TG_MS15	GGGTTAACACAAATGCATAATCAGG	CCTGCACCAATCACAAAGGG	AT
TG_MS16	ATAAAGCATTCCCTAAACGCC	ACTCTACGAAACTCCAGCAC	AAAT
TG_MS18	CCACCGTCTTAGTTCATGCTC	GCTGCGGTGGCGTTAATAC	AG
TG_MS23	AGCTTGAGGAAACCAATGTTAG	GACAACAGGACAAGCTGGG	AT
TG_MS30	TCAAGATTGCCAGTAGGGC	AAGAGGCAAGCTCTTCACC	AAAT
TG_MS37	GCCCATTGTAGACCAGAACC	GCAGGGAAATCGGCTCAAC	AT
TG_MS45	GTGTTGACTCGAATGTTTGCTC	TGGGAATGCTGTTTCTTTCGG	AAT
TG_MS6	ACCACTTTGTTCCGCTTTATCC	CACTGCATCCCAGAGCTTC	AT
TG_MS21	GAGATGGGTTCGGGCTCAC	TTTGGCAAGCGTCACATTC	ATTT
TG_MS22	CACCGGACTAAGCCTGCTC	TCTTACAGTATGGTTCCCAAGC	AT
TG_MS31	GGTTCAACACCGGGTAAGTTC	CGGCTTTCACCAGGCTTTC	AT
TG_MS32	TGGGTAACCTGTTATCGTTTAAG	AGGTACTCTTCTACACTGGTTTG	ATT
TG_MS36	TAGGCCACCGAGCTATTGG	AAATGCTTTATTGCTGCGTAAG	AT
TG_MS38	CGCTGCCTCTCGGACTAC	AGCTTAAATGACGCTTGCAC	AT
TG_MS39	CCTGGTTCATCGAGTTCATCG	AGTCCGGAGCAGCTGAAAG	AT
TG_MS40	GCGCTTTGAATAGTGTTCGC	CGCTTTGGCTTGCTAGGTC	AT
TG_MS41	TGATCGTGCATTCAAATATTGGTG	TACGTGTTGCCATTCTGCG	CT
TG_MS50	TGGTAATCAACCGTTCCTGAAG	GGTGCGTTTACAGATTGACCG	AG
TG_MS55	AGCCCTTCTAGCCTTGAGC	GCGCGACGTTACTACCAATC	AT
